                              
                              
                              
                              
                              
                              
                              
                           ## 
                          #··#
                          #··#
                          #··#
                          #··#
                ##         #·#
               #··#        #·#
               #··##       #·#
               #····#      #·#
               #··#·#      #·#
                ###·#      #·#
                  #·#      #·#
        ###       #·#      #·#
       #···#      #·#      #·#
     ###···#     #··########·#
    #······#     #···········#
    #·##···#######·@#######··#
    #························#
    #·####################### 
   #···#                      
   #···#                      
    #·#                       
    #·#                       
    #·#                       
    #·# ##                    
    #·##··#                   
    #·····#                   
     ###··#         ###       
        #·#       ##···#      
        #·#      #·····#      
        #·#     #··####       
        #·#######··#          
        #··········#          
         ########··#          
                 #·#          
                 #·#          
                 #·#          
                 #·#          
                 #·#          
                ##·#  ##      
               #···###··#     
               #········#     
               #···###··#     
                ##·#  #·#     
                 #·#  #·#  ## 
     ###         #·#  #·# #··#
    #···##########·#  #·###··#
    #··············#  #······#
     #·##···#######    ####··#
     #·##···#              #·#
     #······#              #·#
      ###···#              #·#
         ###               #·#
                   ##      #·#
                  #··#######·#
                  #··········#
                  #··######## 
                   #·#        
                   #·#        
                   #·#        
                   #·#        
                 ###·# ####   
                #····##····#  
     ###        #··········#  
    #···#        #·######·#   
    #···##########·#···##·#   
    #··············#···##·### 
    #···##########·#······#··#
     ###       ###·#···##····#
              #····####  #### 
              #····#          
               ####           
                              
