                              
                              
                              
                       ####   
         ####         #····#  
        #····#        #·····# 
        #····##############·# 
        #···················# 
        #····##############·# 
         ####             #·# 
                          #·# 
                          #·# 
                         ##·# 
                  #######····#
                 #···········#
                 #·######····#
                 #·#     #### 
                 #·##         
    ##          #····#        
   #··####      #····#        
   #······#      #·##         
    #####·#      #·#          
        #·#   ## #·#          
        #·#  #··##·#          
       #··####··##·#          
       #·····#·····#          
       #··##·#··#··#          
        #··········#          
        #·##·####··#          
        #·##·#   #·#          
        #·##·#   #·#          
        #·##·#   #·#          
        #·##·#   #·#          
        #····#   #·#   ##     
        #····#   #·####··#    
         ###·#   #·······#    
           #·#    ######·#    
           #·#   ##    #·#    
           #·#  #··#####·#    
           #·#  #········#    
           #·#  #··######     
           #·#   ##           
           #·#                
           #·#                
           #·#                
 ####      #·##               
#····#     #···###            
#····#######······#           
#··············##·#           
#····#######·## #·#           
 ##·####   #·#  #·#           
  #·····#  #·# ##·#           
  #·····#  #·##····####       
   #####   #·##········#      
           #·##····###·#  ##  
           #·####·###···##··# 
           #················# 
           #·###··########··# 
           #·# #··#       ##  
 ####      #·# #··#           
#····####  #·#  ##            
#········# #·#                
#····###·# #·#                
 ####  #·# #·#                
       #·# #·#                
      #··###·#           ###  
      #······#          #··@# 
       #####·#          #···# 
           #·#           #·#  
           #·#           #·#  
           #·############···# 
          #·················# 
          #···##############  
          #···#               
           ###                
                              
                              
                              
                              
                              
